https://ftp.pwg.org/pub/pwg/ipp/wd/wd-ippstorage10-20210129.pdf

Printer Status attributes:	Reference
------------------------------	---------
printer-storage (1setOf octetString(MAX))	[STORAGE]
printer-storage-description (1setOf text(MAX))	[STORAGE]


Attributes (attribute syntax)
  Keyword Attribute Value	Reference
  -----------------------	---------
printer-state-reasons (1setOf type2 keyword)	[STD92]
  storage-added	[STORAGE]
  storage-almost-full	[STORAGE]
  storage-cover-closed	[STORAGE]
  storage-cover-open	[STORAGE]
  storage-configuration-change	[STORAGE]
  storage-full	[STORAGE]
  storage-interlock-closed	[STORAGE]
  storage-interlock-open	[STORAGE]
  storage-life-almost-over	[STORAGE]
  storage-life-over	[STORAGE]
  storage-missing	[STORAGE]
  storage-offline	[STORAGE]
  storage-over-temperature	[STORAGE]
  storage-power-saver	[STORAGE]
  storage-recoverable-failure	[STORAGE]
  storage-removed	[STORAGE]
  storage-thermistor-failure	[STORAGE]
  storage-turned-off	[STORAGE]
  storage-turned-on	[STORAGE]
  storage-under-temperature	[STORAGE]
  storage-unrecoverable-failure	[STORAGE]
  storage-warming-up	[STORAGE]
